          _                                _                
 ________| |____ ___ __   _   ________ ___| |____ _   _   _ 
|.  ___  |____  |_  |\ \ | | |.  ___  |_  |____  | | | | | |
 | |   | |   / /  | | \ \| |  | |   | | | |   / /| | | | | |
 | |___| |  / /   | |__\ ` |  | |___| | | |  / / | |/ /_/ / 
 |_______| /_/    |_|______|  |_______| |_| /_/  |_______/  
                                                            

